ise	N-to-V
ize	N-to-V
ite	N-to-V
ate	N-to-V
en	N-to-V
ify	N-to-V
ation	V-to-N
ion	V-to-N
er	V-to-N
ee	V-to-N
ment	V-to-N
ant	V-to-N
ent	V-to-N
ity	V-to-N
ism	V-to-N
age	V-to-N
al	V-to-N
ence	V-to-N
ance	V-to-N
nce	V-to-N
ing	V-to-N
ist	V-to-N